1100660697
1100664375
1100667843
1100726010
1100819552
1100967459
1100980910
1101019358
1101424497
1101425146
1101434495
1101611843
1101712775
1102066337
1102103172
1102118404
1102159837
1102206301
1102248101
1102279929
1102299116
1102307500
1102318302
1102358224
1102390684
1102396326
1102397683
1102397722
1102398181
1102405034
1102409212
1102415483
1102415730
1102416935
1102418902
1102419680
1102420995
1102421773
1102421787
1102427303
1102429213
1102429307
1102431779
1102434945
1102435417
1102435815
1102438121
1102438325
1102438821
1102447711
1102457127
1102462888
1102475157
1102480225
1102482042
1102484576
1102484590
1102484810
1102487169
1102494328
1102495596
1102496896
1102498601
1102505600
1102513059
1102526049
1102532185